#rows, #columns, optional delay, optional chamber size
25 25
W W W W W W W W W W W W W W W W W W W W W W W W W
 W S U U U W W W W W W W W W W W W W W W W W W W W
W U W W U U W W W W W W W W W W W W W W W W W W W
 W W U W W U U W W W W W W W W W W W W W W W W W W
W W W W W W U U W W W W W W W W W W W W W W W W W
 W W W W W W U U W W W W W W W W W W W W W W W W W
W W W W W W U U W W W W W W W W W W W W W W W W W
 W W W W W W U U W W W W W W W W W W W W W W W W W
W W W W W W U U W W W W W W W W W W W W W W W W W
 W W W W W W U U W W W W W W W W W W W W W W W W W
W W W W W W U U W W W W W W W W W W W W W W W W W
 W W W W W W U U W W W W W W W W W W W W W W W W W
W W W W W W U U W W W W W W W W W W W W W W W W W
 W W W W W W U U W W W W W W W W W W W W W W W W W
W W W W W W U U W W W W W W W W W W W W W W W W W
 W W W W W W U U W W W W W W W W W W W W W W W W W
W W W W W W U U W W W W W W W W W W W W W W W W W
 W W W W W W U U W W W W W W W W W W W W W W W W W
W W W W W W U U W W W W W W W W W W W W W W W W W
 W W W W W W U U W W W W W W W W W W W W W W W W W
W W W W W W U U W W W W W W W W W W W W W W W W W
 W W W W W W U U W W W W W W W W W W W W W W W W W
W W W W W W U U W W W W W W W W W W W W W W W W W
 W W W W W W U U W W W W W W W W W W W W W W W W E
W W W W W W W W W W W W W W W W W W W W W W W W W